
Extend?????????÷Œ¶ ?????

|-Action	?
|-Behavior	??
|-Driver	?
|  Driver/Cache		
|  Driver/Db		?
|  Driver/Session	SESSION
|  Driver/TagLib	?
|  Driver/Template	?
|
|-Engine	?
|-Function	?
|-Library	?
|  ORG	ORG
|  COM	COM
|
|-Mode	???
|-Model	??
|-Tool	???
|-Vendor	??

????¶œ????